(0, 0)
--------------------
--------------------
--------------------
--------------------
--------------------
--------------------
------------N-------
--------------------
--------------------
-C------------------
--------------------
IIIIIIIIIIIIIIIIIIII
IIIIIIIIIIIIIIIIIIII
IIIIIIIIIIIIIIIIIIII
IIIIIIIIIIIIIIIIIIII

