(0, 0)
--------------------
--------------------
--------------------
--------------------
--------------------
--------------------
--------------------
--------------------
--------------------
-C------------------
--------------------
IIIIIII~~~~~~~~~IIII
IIIIIII=========IIII
IIIIIIIIIIIIIIIIIIII
IIIIIIIIIIIIIIIIIIII

