(0, -1)
GI----------------GG
GI----------------GG
GI----------------GG
GI----------------GG
GI----------------GG
GI----------------GG
GI----------------GG
GI----------------GG
GI----------------GG
GI----------------GG
GI----------------GG
GI----------------GG
GI----------------GG
GI----------------GG
GI----------------GG

(0, 0)
--------------------
--------------------
--------------------
--------------------
--------------------
--------------------
--------------------
--------------------
--------------------
--------------------
--------------------
--------------------
IIIIIIIIIIIIIIIIIIII
IIIIIIIIIIIIIIIIIIII
IIIIIIIIIIIIIIIIIIII

