(0, 0, sky)
GG----------------GG
GG----------------GG
GG----------------GG
GG----------IG----GG
GG----------IG---*GG
GG----------IG--**GG
GG----------IG---*GG
GG----------IG----GG
GG----------IG----GG
GG----------------GG
GG----------------GG
GG-C-02-----z-----GG
GGGGGGGGGGGGGGGGGGGG
GGGGGGGGGGGGGGGGGGGG
GGGGGGGGGGGGGGGGGGGG

