(0, -1)
GI----------------GG
GI----------------GG
GI----------------GG
GI----------------GG
GI----------------GG
GI----------------GG
GI----------------GG
GI----------------GG
GI----------------GG
GI----------------GG
GI----------------GG
GI----------------GG
GI----------------GG
GI----------------GG
GI----------------GG

(0, 0)
GI----------------GG
GI----------------GG
GI----------------GG
GI----------------GG
GI----------------GG
GI----------------GG
GI----------------GG
GI----------------GG
GI----------------GG
GI----------------GG
GI-C-----P--------GG
GI----------------GG
IIIIIIIIIIIIIIIIIIII
IIIIIIIIIIIIIIIIIIII
IIIIIIIIIIIIIIIIIIII

