(2, 0)
--------------------
--------------------
--------------------
--------------------
--------------------
--------------------
----------c---------
-----#MMMMMMMM#-----
-----#--------#-----
-----#--------#-----
--C--#--------#-----
-----#--------#-----
RRRRRR~~~~~~~~RRRRRR
RRRRRR========RRRRRR
RRRRRRRRRRRRRRRRRRRR

(1, 0)
-----------------RR-
-----------------RR-
-----------------RR-
------------RR---RR-
-------s----RR---RR-
------------RR---RR-
------------RR---RR-
------------RR---RR-
------------RR---RR-
------------RR------
--------------------
---------c----------
RRRRRR--P-----RRRRRR
RRRRRRRRRRRRRRRRRRRR
RRRRRRRRRRRRRRRRRRRR

(0, 0)
RRR---------RRRR----
RRR--------RRR------
RRR------RRRR-------
R--------RRRR-------
R------RRR----------
R------RR-----------
R---RRRR------------
RR#---R-------------
RR#-----------------
RR#-----------------
RR#-C---------------
RRR-----0356247-RR--
RRRRRRRRRRRRRRRZRRRR
RRRRRRRRRRRRRRRRRRRR
RRRRRRRRRRRRRRRRRRRR

(0, -1)
--------------------
--------------------
--------------------
--------------------
--------------------
--------------------
--------------------
--------------------
--------------------
--------------------
--------------------
--------------------
RR------------------
RRR-----------------
RRR---------RRRR----

