(2, 0)
--------------------
--------------------
--------------------
--------------------
--------------------
--------------------
----------c---------
-----#MMMMMMMM#-----
-----#--------#-----
-----#--------#-----
-----#--------#-----
-----#--------#-----
RRRRRR~~~~~~~~RRRRRR
RRRRRR========RRRRRR
RRRRRRRRRRRRRRRRRRRR

(1, 0)
--------------------
--------------------
--------------------
--------------------
--------------s-----
--------------------
--------------------
--------------------
--------------------
--------------------
---------------h----
--------------------
RRR~~~~~~RRRRRIIIIRR
RRR======RRRRRRRRRRR
RRRRRRRRRRRRRRRRRRRR

(0, 0)
RRR-----------------
RRR-----------------
RRR-----------------
R-------------------
R-------------------
R-------------------
R-------------------
RR#-----------------
RR#-----------------
RR#-----------------
RR#-C---------------
RRR-----0356247-RR--
RRRRRRRRRRRRRRRRRRRR
RRRRRRRRRRRRRRRRRRRR
RRRRRRRRRRRRRRRRRRRR

