(2, 0)
--------------------
--------------------
--------------------
--------------------
--------------------
--------------------
----------c---------
-----#MMMMMMMM#-----
-----#--------#-----
-----#--------#-----
--C--#--------#-----
-----#--------#-----
RRRRRR~~~~~~~~RRRRRR
RRRRRR========RRRRRR
RRRRRRRRRRRRRRRRRRRR

(1, 0)
-----------------RR-
-----------------RR-
-----------------RR-
------------RR---RR-
-------s----RR---RR-
------------RR---RR-
------------RR---RR-
------------RR---RR-
------------RR---RR-
------------RR------
--------------------
---------c----------
RRRRRR--P-----RRRRRR
RRRRRRRRRRRRRRRRRRRR
RRRRRRRRRRRRRRRRRRRR

(0, 0)
RRR-----------------
RRR-----------------
RRR-----------------
R-------------------
R-------------------
R-------------------
R-------------------
RR#-----------------
RR#-----------------
RR#-----------------
RR#-C---------------
RRR-----0356247-RR--
RRRRRRRRRRRRRRRRRRRR
RRRRRRRRRRRRRRRRRRRR
RRRRRRRRRRRRRRRRRRRR

